################################
#.......##...#....####....##...#
#.......##......../..#....##...#
#............#....##...........#
#............#########.........#
#.......##...####...######..####
#.......##...###.....#####..####
###..#####...##.......###.....##
###..#####...#.........##.....##
###..###...../........./......##
###..###.....#.........##......#
#......#.....##.......###......#
#......#.....###.....####......#
#......#.....####...#####......#
#......#.....#####.########.####
#......#.....##.........###.####
#......###..###.........###.####
#......###..###.........##...###
##/##/##.....##......#.##.....##
##.##................#........##
#...####.............####.....##
#...####.....##......#####...###
#...###########......###########
################################