###############################
#.......##...#....####....##..#
#.......##...........#....##..#
#............#....##..........#
#............#########........#
#.......##...####...######..###
#.......##...###.....#####..###
###..#####...##.......###.....#
###..#####...#.........##.....#
###..###......................#
###..###.....#.........##.....#
#......#.....##.......###.....#
#......#.....###.....####.....#
#......#.....####...#####.....#
#......#.....#####.########.###
#......#.....##.........###.###
#......###..###.........###.###
#......###..###.........##...##
##.##.##.....##......#.##.....#
##.##................#........#
#...####.............####.....#
#...####.....##......#####...##
#...###########......##########
###############################